{//6–Ê‡A
{
{14,14,14,14,14,14,14,14,14,14,14,14,14,14,14},
{14, 0, 0, 0, 0, 0, 0, 0, 0, 0, 0, 0, 1, 1,14},
{14, 0, 0, 0, 0, 0, 0, 0, 0, 0, 0, 0, 0, 0,14}, 
{14, 0, 0, 1, 1, 1, 1, 1, 1, 1, 1, 1, 0, 0,14},
{14, 0, 0, 1, 1, 1, 1, 1, 1, 1, 1, 1, 0, 0,14},
{14, 0, 0, 1, 1, 1, 1, 1, 1, 1, 1, 1, 1, 1,14},
{14, 0, 0, 1, 1, 1, 1, 1, 1, 1, 1, 1, 0, 0,14},
{14, 0, 0, 1, 1, 1, 1, 1, 1, 1, 1, 1, 0, 0,14},
{14, 0, 0, 1, 1, 1, 1, 1, 1, 1, 1, 1, 1, 1,14},
{14, 0, 0, 1, 1, 1, 1, 1, 1, 1, 1, 1, 0, 0,14},
{14, 0, 0, 1, 1, 1, 1, 1, 1, 1, 1, 1, 9, 0,14},
{14, 0, 0, 1, 1, 1, 1, 1, 1, 1, 1, 1, 0, 0,14},
{14, 0, 0, 0, 0, 0, 0, 0, 0, 0, 0, 0, 0, 0,14},
{14, 0, 0, 0, 0, 0, 0, 0, 0, 0, 0, 0, 0, 0,14},
{14,14,14,14,14,14,14,14,14,14,14,14,14,14,14}
},//6–Ê‡B
{
{14,14,14,14,14,14,14,14,14,14,14,14,14,14,14},
{14, 0, 0, 0, 0, 0, 0, 0, 0, 0, 0, 0, 1, 0,14},
{14, 0, 0, 0, 0, 0, 0, 0, 0, 0, 0, 0, 0, 0,14}, 
{14, 0, 0, 1, 1, 1, 1, 1, 1, 1, 1, 1, 0, 0,14},
{14, 0, 0, 1, 1, 1, 1, 1, 1, 1, 1, 1, 0, 0,14},
{14, 0, 0, 1, 1, 1, 1, 1, 1, 1, 1, 1, 1, 1,14},
{14, 0, 0, 1, 1, 1, 1, 1, 1, 1, 1, 1, 0, 0,14},
{14, 0, 0, 1, 1, 1, 1, 1, 1, 1, 1, 1, 0, 0,14},
{14, 0, 0, 1, 1, 1, 1, 1, 1, 1, 1, 1, 1, 1,14},
{14, 0, 0, 1, 1, 1, 1, 1, 1, 1, 1, 1, 0, 0,14},
{14, 0, 0, 1, 1, 1, 1, 1, 1, 1, 1, 1, 0, 0,14},
{14, 0, 0, 1, 1, 1, 1, 1, 1, 1, 1, 1, 0, 0,14},
{14, 0, 0, 0, 0, 0, 0, 0, 0, 0, 0, 0, 0, 0,14},
{14, 0, 0, 0, 0, 0, 0, 0, 0, 0, 0, 0, 0, 0,14},
{14,14,14,14,14,14,14,14,14,14,14,14,14,14,14}
},
//7–Ê‡@(6–ÊƒMƒ~ƒbƒN‚ ‚èŒŠ‚ ‚è)
{
{14,14,14,14,14,14,14,14,14,14,14,14,14,14,14},
{14, 1, 1, 1, 0, 0, 1, 1, 1, 1, 1, 1, 0, 0,14},
{14, 1, 1, 1, 0, 0, 1, 1, 1, 1, 1, 1, 0, 0,14}, 
{14, 0, 0, 1, 1, 1, 1, 1, 1, 1, 1, 1, 0, 0,14},
{14, 0, 0, 1, 1, 1, 1, 1, 1, 1, 1, 1, 0, 0,14},
{14, 0, 0, 1, 1, 1, 1, 1, 1, 1, 1, 1, 2, 1,14},
{14, 0, 0, 1, 1, 1, 1, 1, 1, 1, 1, 1, 0, 5,14},
{14, 0, 0, 1, 1, 1, 1, 1, 1, 1, 1, 1, 0, 0,14},
{14, 0, 0, 1, 1, 1, 1, 1, 1, 1, 1, 1, 0, 0,14},
{14, 0, 0, 1, 1, 1, 1, 1, 1, 1, 1, 1, 0, 0,14},
{14, 0, 0, 1, 1, 1, 1, 1, 1, 1, 1, 1, 0, 0,14},
{14, 0, 0, 1, 1, 1, 1, 1, 1, 1, 1, 1, 0, 0,14},
{14, 0, 0, 0, 0, 0, 0, 0, 0, 0, 0, 0, 0, 0,14},
{14, 0, 0, 0, 0, 0, 0, 0, 0, 0, 0, 0, 0, 0,14},
{14,14,14,14,14,14,14,14,14,14,14,14,14,14,14}
},
//7–Ê‡AFJIƒAƒCƒeƒ€‚ ‚è
{
{14,14,14,14,14,14,14,14,14,14,14,14,14,14,14},
{14, 1, 0, 1, 0, 0, 0, 0,10, 0, 1, 0, 0, 0,14},
{14, 1, 0, 1, 0, 0, 0, 0, 0, 0, 1, 0, 0, 0,14}, 
{14, 0, 0, 1, 1, 1, 1, 1, 1, 1, 1, 1, 0, 0,14},
{14, 0, 0, 1, 1, 1, 1, 1, 1, 1, 1, 1, 0, 0,14},
{14, 0, 0, 1, 1, 1, 1, 1, 1, 1, 1, 1, 0, 0,14},
{14, 0, 0, 1, 1, 1, 1, 1, 1, 1, 1, 1, 0, 0,14},
{14, 0, 0, 1, 1, 1, 1, 1, 1, 1, 1, 1, 0, 0,14},
{14, 0, 0, 1, 1, 1, 1, 1, 1, 1, 1, 1, 0, 0,14},
{14, 0, 0, 1, 1, 1, 1, 1, 1, 1, 1, 1, 0, 0,14},
{14, 0, 0, 1, 1, 1, 1, 1, 1, 1, 1, 1, 0, 0,14},
{14, 0, 0, 1, 1, 1, 1, 1, 1, 1, 1, 1, 0, 0,14},
{14, 0, 0, 0, 0, 0, 0, 0, 0, 0, 0, 0, 0, 0,14},
{14, 0, 0, 0, 0, 0, 0, 0, 0, 0, 0, 0, 0, 0,14},
{14,14,14,14,14,14,14,14,14,14,14,14,14,14,14}
},
//7–Ê‡B
{
{14,14,14,14,14,14,14,14,14,14,14,14,14,14,14},
{14, 0, 0, 1, 0, 0, 0, 0, 0, 0, 1, 0, 0, 0,14},
{14, 1, 0, 1, 0, 0, 0, 0, 0, 0, 1, 0, 0, 0,14}, 
{14, 0, 0, 1, 1, 1, 1, 1, 1, 1, 1, 1, 0, 0,14},
{14, 0, 0, 1, 1, 1, 1, 1, 1, 1, 1, 1, 0, 0,14},
{14, 0, 0, 1, 1, 1, 1, 1, 1, 1, 1, 1, 0, 0,14},
{14, 0, 0, 1, 1, 1, 1, 1, 1, 1, 1, 1, 0, 0,14},
{14, 0, 0, 1, 1, 1, 1, 1, 1, 1, 1, 1, 0, 0,14},
{14, 0, 0, 1, 1, 1, 1, 1, 1, 1, 1, 1, 0, 0,14},
{14, 0, 0, 1, 1, 1, 1, 1, 1, 1, 1, 1, 0, 0,14},
{14, 0, 0, 1, 1, 1, 1, 1, 1, 1, 1, 1, 0, 0,14},
{14, 0, 0, 1, 1, 1, 1, 1, 1, 1, 1, 1, 0, 0,14},
{14, 0, 0, 0, 0, 0, 0, 0, 0, 0, 0, 0, 0, 0,14},
{14, 0, 0, 0, 0, 0, 0, 0, 0, 0, 0, 0, 0, 0,14},
{14,14,14,14,14,14,14,14,14,14,14,14,14,14,14}
},
//8–Ê‡@
{
{14,14,14,14,14,14,14,14,14,14,14,14,14,14,14},
{14, 0, 0, 0, 0, 0, 0, 0, 0, 0, 0, 0, 0, 0,14},
{14, 0, 0, 0, 0, 0, 0, 0, 0, 0, 0, 0, 0, 0,14}, 
{14, 1, 1, 1, 1, 1, 1, 1, 1, 1, 1, 1, 0, 0,14},
{14,12, 1, 1, 1, 1, 1, 1, 1, 1, 1, 1, 0, 0,14},
{14, 1, 1, 1, 1, 1, 1, 1, 1, 1, 1, 1, 0, 0,14},
{14, 1, 0, 1, 1, 1, 1, 1, 1, 1, 1, 1, 0, 0,14},
{14, 2, 0, 1, 1, 1, 1, 1, 1, 1, 1, 1, 0, 0,14},
{14, 3, 0, 1, 1, 1, 1, 1, 1, 1, 1, 1, 0, 0,14},
{14, 4, 0, 1, 1, 1, 1, 1, 1, 1, 1, 1, 0, 0,14},
{14, 2, 0, 1, 1, 1, 1, 1, 1, 1, 1, 1, 0, 0,14},
{14, 3, 0, 1, 1, 1, 1, 1, 1, 1, 1, 1, 0, 0,14},
{14, 4, 0, 0, 0, 0, 0, 0, 0, 0, 0, 0, 0, 0,14},
{14, 1, 1, 0, 0, 0, 0, 0, 0, 0, 0, 0, 0, 0,14},
{14,14,14,14,14,14,14,14,14,14,14,14,14,14,14}
},

//8–Ê‡@
{
{14,14,14,14,14,14,14,14,14,14,14,14,14,14,14},
{14, 0, 0, 0, 0, 0, 0, 0, 0, 0, 0, 0, 0, 0,14},
{14, 0, 0, 0, 0, 0, 0, 0, 0, 0, 0, 0, 0, 0,14}, 
{14, 0, 0, 1, 1, 1, 1, 1, 1, 1, 1, 1, 0, 0,14},
{14, 0, 1, 1, 1, 1, 1, 1, 1, 1, 1, 1, 0, 0,14},
{14, 0, 0, 1, 1, 1, 1, 1, 1, 1, 1, 1, 0, 0,14},
{14, 1, 0, 1, 1, 1, 1, 1, 1, 1, 1, 1, 0, 0,14},
{14, 2, 0, 1, 1, 1, 1, 1, 1, 1, 1, 1, 0, 0,14},
{14, 3, 0, 1, 1, 1, 1, 1, 1, 1, 1, 1, 0, 0,14},
{14, 4, 0, 1, 1, 1, 1, 1, 1, 1, 1, 1, 0, 0,14},
{14, 2, 0, 1, 1, 1, 1, 1, 1, 1, 1, 1, 0, 0,14},
{14, 3, 0, 1, 1, 1, 1, 1, 1, 1, 1, 1, 0, 0,14},
{14, 4, 1, 0, 0, 0, 0, 0, 0, 0, 0, 0, 0, 0,14},
{14, 0, 1, 0, 0, 0, 0, 0, 0, 0, 0, 0, 0, 0,14},
{14,14,14,14,14,14,14,14,14,14,14,14,14,14,14}
}

};

