{//6–Ê
{
{14,14,14,14,14,14,14,14,14,14,14,14,14,14,14},
{14, 1, 1, 1, 1, 1, 1, 1, 1, 1, 1, 1, 1, 1,14},
{14, 1, 1, 1, 1, 1, 1, 1, 1, 1, 1, 1, 1, 1,14}, 
{14, 1, 1, 1, 1, 1, 1, 1, 1, 1, 1, 1, 1, 1,14},
{14, 1, 1, 1, 1, 1, 1, 1, 1, 1, 1, 1, 1, 1,14},
{14, 1, 1, 1, 1, 1, 1, 1, 1, 1, 1, 1, 1, 1,14},
{14, 1, 1, 1, 1, 1, 1, 1, 1, 1, 1, 1, 1, 1,14},
{14, 1, 1, 1, 1, 1, 1, 1, 1, 1, 1, 1, 1, 1,14},
{14, 1, 1, 1, 1, 1, 1, 1, 1, 1, 1, 1, 1, 1,14},
{14, 1, 1, 1, 1, 1, 1, 1, 1, 1, 1, 1, 1, 1,14},
{14, 1, 1, 1, 1, 1, 1, 1, 1, 1, 1, 1, 1, 1,14},
{14, 1, 1, 1, 1, 1, 1, 1, 1, 1, 1, 1, 1, 1,14},
{14, 1, 1, 1, 1, 1, 1, 1, 1, 1, 1, 1, 1, 1,14},
{14, 1, 1, 1, 1, 1, 1, 1, 1, 1, 1, 1, 1, 1,14},
{14,14,14,14,14,14,14,14,14,14,14,14,14,14,14}
},//
{
{14,14,14,14,14,14,14,14,14,14,14,14,14,14,14},
{14, 0, 0, 0, 0, 0, 0, 4, 0, 0, 0, 0, 0, 0,14},
{14, 0, 1, 1, 1, 1, 1, 1, 1, 1, 1, 1, 1, 0,14}, 
{14, 0, 1, 1, 1, 1, 1, 1, 1, 1, 1, 1, 1, 0,14},
{14, 0, 1, 1, 1, 1, 1, 1, 1, 1, 1, 1, 1, 0,14},
{14, 0, 1, 1, 1, 1, 1, 1, 1, 1, 1, 1, 1, 0,14},
{14, 0, 1, 1, 1, 1, 1, 1, 1, 1, 1, 1, 1, 0,14},
{14, 2, 1, 1, 1, 1, 1, 1, 1, 1, 1, 1, 1, 0,14},
{14, 0, 1, 1, 1, 1, 1, 1, 1, 1, 1, 1, 1, 1,14},
{14, 0, 1, 1, 1, 1, 1, 1, 1, 1, 1, 1, 1, 0,14},
{14, 0, 1, 1, 1, 1, 1, 1, 1, 1, 1, 1, 1, 0,14},
{14, 0, 1, 1, 1, 1, 1, 1, 1, 1, 1, 1, 1, 0,14},
{14, 0, 1, 1, 1, 1, 1, 1, 1, 1, 1, 1, 1, 0,14},
{14, 0, 0, 0, 0, 0, 0, 3, 0, 0, 0, 0, 0, 0,14},
{14,14,14,14,14,14,14,14,14,14,14,14,14,14,14}
},//
{
{14,14,14,14,14,14,14,14,14,14,14,14,14,14,14},
{14, 0, 0, 0, 0, 0, 0, 4, 0, 0, 0, 0, 0, 0,14},
{14, 0, 0, 0, 0, 0, 0, 4, 0, 0, 0, 0, 0, 0,14}, 
{14, 0, 0, 1, 1, 1, 1, 1, 1, 1, 1, 1, 0, 0,14},
{14, 0, 0, 1, 1, 1, 1, 1, 1, 1, 1, 1, 0, 0,14},
{14, 0, 0, 1, 1, 1, 1, 1, 1, 1, 1, 1, 0, 0,14},
{14, 0, 0, 1, 1, 1, 1, 1, 1, 1, 1, 1, 0, 0,14},
{14, 2, 2, 1, 1, 1, 1, 1, 1, 1, 1, 1, 1, 1,14},
{14, 0, 0, 1, 1, 1, 1, 1, 1, 1, 1, 1, 0, 0,14},
{14, 0, 0, 1, 1, 1, 1, 1, 1, 1, 1, 1, 0, 0,14},
{14, 0, 0, 1, 1, 1, 1, 1, 1, 1, 1, 1, 0, 0,14},
{14, 0, 0, 1, 1, 1, 1, 1, 1, 1, 1, 1, 0, 0,14},
{14, 0, 0, 0, 0, 0, 0, 3, 0, 0, 0, 0, 0, 0,14},
{14, 0, 0, 0, 0, 0, 0, 3, 0, 0, 0, 0, 0, 0,14},
{14,14,14,14,14,14,14,14,14,14,14,14,14,14,14}
},//

{
{14,14,14,14,14,14,14,14,14,14,14,14,14,14,14},
{14, 0, 0, 0, 0, 0, 0, 4, 0, 0, 0, 0, 0, 0,14},
{14, 0, 0, 0, 0, 0, 0, 4, 0, 0, 0, 0, 0, 0,14}, 
{14, 0, 0, 0, 0, 0, 0, 4, 0, 0, 0, 0, 0, 0,14},
{14, 0, 0, 0, 1, 1, 1, 1, 1, 1, 1, 0, 0, 0,14},
{14, 0, 0, 0, 1, 1, 1, 1, 1, 1, 1, 0, 0, 0,14},
{14, 0, 0, 0, 1, 1, 1, 1, 1, 1, 1, 0, 0, 0,14},
{14, 2, 2, 2, 1, 1, 1, 1, 1, 1, 1, 1, 1, 1,14},
{14, 0, 0, 0, 1, 1, 1, 1, 1, 1, 1, 0, 0, 0,14},
{14, 0, 0, 0, 1, 1, 1, 1, 1, 1, 1, 0, 0, 0,14},
{14, 0, 0, 0, 1, 1, 1, 1, 1, 1, 1, 0, 0, 0,14},
{14, 0, 0, 0, 0, 0, 0, 3, 0, 0, 0, 0, 0, 0,14},
{14, 0, 0, 0, 0, 0, 0, 3, 0, 0, 0, 0, 0, 0,14},
{14, 0, 0, 0, 0, 0, 0, 3, 0, 0, 0, 0, 0, 0,14},
{14,14,14,14,14,14,14,14,14,14,14,14,14,14,14}
},//

{
{14,14,14,14,14,14,14,14,14,14,14,14,14,14,14},
{14, 0, 0, 0, 0, 0, 0, 4, 0, 0, 0, 0, 0, 0,14},
{14, 0, 0, 0, 0, 0, 0, 4, 0, 0, 0, 0, 0, 0,14}, 
{14, 0, 0, 0, 0, 0, 0, 4, 0, 0, 0, 0, 0, 0,14},
{14, 0, 0, 0, 0, 0, 0, 4, 0, 0, 0, 0, 0, 0,14},
{14, 0, 0, 0, 0, 1, 1, 1, 1, 1, 0, 0, 0, 0,14},
{14, 0, 0, 0, 0, 1, 1, 1, 1, 1, 0, 0, 0, 0,14},
{14, 2, 2, 2, 2, 1, 1, 1, 1, 1, 1, 1, 1, 1,14},
{14, 0, 0, 0, 0, 1, 1, 1, 1, 1, 0, 0, 0, 0,14},
{14, 0, 0, 0, 0, 1, 1, 1, 1, 1, 0, 0, 0, 0,14},
{14, 0, 0, 0, 0, 0, 0, 3, 0, 0, 0, 0, 0, 0,14},
{14, 0, 0, 0, 0, 0, 0, 3, 0, 0, 0, 0, 0, 0,14},
{14, 0, 0, 0, 0, 0, 0, 3, 0, 0, 0, 0, 0, 0,14},
{14, 0, 0, 0, 0, 0, 0, 3, 0, 0, 0, 0, 0, 0,14},
{14,14,14,14,14,14,14,14,14,14,14,14,14,14,14}
},//

{
{14,14,14,14,14,14,14,14,14,14,14,14,14,14,14},
{14, 0, 0, 0, 0, 0, 0, 4, 0, 0, 0, 0, 0, 0,14},
{14, 0, 0, 0, 0, 0, 0, 4, 0, 0, 0, 0, 0, 0,14}, 
{14, 0, 0, 0, 0, 0, 0, 4, 0, 1, 1, 1, 0, 0,14},
{14, 0, 0, 0, 0, 0, 0, 4, 0, 1, 1, 1, 0, 0,14},
{14, 0, 0, 0, 0, 0, 0, 4, 0, 1, 1, 1, 0, 0,14},
{14, 0, 0, 0, 0, 0, 1, 1, 1, 0, 0, 0, 0, 0,14},
{14, 2, 2, 2, 2, 2, 1, 1, 1, 1, 1, 1, 1, 1,14},
{14, 0, 0, 0, 0, 0, 1, 1, 1, 0, 0, 0, 0, 0,14},
{14, 0, 0, 0, 0, 0, 0, 3, 0, 0, 0, 0, 0, 0,14},
{14, 0, 0, 0, 0, 0, 0, 3, 0, 0, 0, 0, 0, 0,14},
{14, 0, 0, 0, 0, 0, 0, 3, 0, 0, 0, 0, 0, 0,14},
{14, 0, 0, 0, 0, 0, 0, 3, 0, 0, 0, 0, 0, 0,14},
{14, 0, 0, 0, 0, 0, 0, 3, 0, 0, 0, 0, 0, 0,14},
{14,14,14,14,14,14,14,14,14,14,14,14,14,14,14}
},
{
{14,14,14,14,14,14,14,14,14,14,14,14,14,14,14},
{14, 0, 0, 0, 0, 0, 0, 4, 0, 0, 0, 0, 0, 0,14},
{14, 0, 0, 0, 0, 0, 0, 4, 0, 0, 0, 0, 0, 0,14}, 
{14, 0, 0, 0, 0, 0, 0, 4, 0, 1, 1, 1, 0, 0,14},
{14, 0, 0, 0, 0, 0, 0, 4, 0, 1, 1, 1, 0, 0,14},
{14, 0, 0, 0, 0, 0, 0, 4, 0,11, 1, 1, 0, 0,14},
{14, 0, 0, 0, 0, 0, 0, 1, 0, 0, 0, 0, 0, 0,14},
{14, 2, 2, 2, 2, 2, 1, 1, 1, 1, 1, 1, 1, 1,14},
{14, 0, 0, 0, 0, 0, 0, 1, 0, 0, 0, 0, 0, 0,14},
{14, 0, 0, 0, 0, 0, 0, 3, 0, 0, 0, 0, 0, 0,14},
{14, 0, 0, 0, 0, 0, 0, 3, 0, 0, 0, 0, 0, 0,14},
{14, 0, 0, 0, 0, 0, 0, 3, 0, 0, 0, 0, 0, 0,14},
{14, 0, 0, 0, 0, 0, 0, 3, 0, 0, 0, 0, 0, 0,14},
{14, 0, 0, 0, 0, 0, 0, 3, 0, 0, 0, 0, 0, 0,14},
{14,14,14,14,14,14,14,14,14,14,14,14,14,14,14}
},
{
{14,14,14,14,14,14,14,14,14,14,14,14,14,14,14},
{14, 0, 0, 0, 0, 0, 0, 4, 0, 0, 0, 0, 0, 0,14},
{14, 0, 0, 0, 0, 0, 0, 4, 0, 0, 0, 0, 0, 0,14}, 
{14, 0, 0, 0, 0, 0, 0, 4, 0, 1, 1, 1, 0, 0,14},
{14, 0, 0, 0, 0, 0, 0, 4, 0, 1, 1, 1, 0, 0,14},
{14, 0, 0, 0, 0, 7, 0, 4, 0, 0, 1, 1, 0, 0,14},
{14, 0, 0, 0, 0, 0, 0, 1, 0, 0, 0, 0, 0, 0,14},
{14, 2, 2, 2, 2, 2, 1, 1, 1, 1, 1, 1, 1, 1,14},
{14, 0, 0, 0, 0, 0, 0, 1, 0, 0, 0, 0, 0, 0,14},
{14, 0, 0, 0, 0, 6, 0, 3, 0, 5, 0, 0, 0, 0,14},
{14, 0, 0, 0, 0, 0, 0, 3, 0, 0, 0, 0, 0, 0,14},
{14, 0, 0, 0, 0, 0, 0, 3, 0, 0, 0, 0, 0, 0,14},
{14, 0, 0, 0, 0, 0, 0, 3, 0, 0, 0, 0, 0, 0,14},
{14, 0, 0, 0, 0, 0, 0, 3, 0, 0, 0, 0, 0, 0,14},
{14,14,14,14,14,14,14,14,14,14,14,14,14,14,14}
},

{
{14,14,14,14,14,14,14,14,14,14,14,14,14,14,14},
{14, 0, 0, 0, 0, 0, 0, 4, 0, 0, 0, 0, 0, 0,14},
{14, 0, 0, 0, 0, 0, 0, 4, 0, 0, 0, 0, 0, 0,14}, 
{14, 0, 0, 0, 0, 0, 0, 4, 0, 1, 1, 1, 0, 0,14},
{14, 0, 0, 0, 0, 0, 0, 4, 0, 1, 1, 1, 0, 0,14},
{14, 0, 0, 0, 0, 0, 0, 4, 0, 1, 1, 1, 0, 0,14},
{14, 0, 0, 0, 0, 0, 0, 1, 0, 0, 0, 0, 0, 0,14},
{14, 2, 2, 2, 2, 2, 1, 1, 1, 1, 1, 1, 1, 1,14},
{14, 0, 0, 0, 0, 0, 0, 1, 0, 0, 0, 0, 0, 0,14},
{14, 0, 0, 0, 0, 0, 0, 3, 0, 0, 0, 0, 0, 0,14},
{14, 0, 0, 0, 0, 0, 0, 3, 0, 0, 0, 0, 0, 0,14},
{14, 0, 0, 0, 0, 0, 0, 3, 0, 0, 0, 0, 0, 0,14},
{14, 0, 0, 0, 0, 0, 0, 3, 0, 0, 0, 0, 0, 0,14},
{14, 0, 0, 0, 0, 0, 0, 3, 0, 0, 0, 0, 0, 0,14},
{14,14,14,14,14,14,14,14,14,14,14,14,14,14,14}
},

{
{14,14,14,14,14,14,14,14,14,14,14,14,14,14,14},
{14, 0, 0, 0, 0, 0, 0, 4, 0, 0, 0, 0, 0, 0,14},
{14, 0, 0, 0, 0, 0, 0, 4, 0, 0, 0, 0, 0, 0,14}, 
{14, 0, 0, 0, 0, 0, 0, 4, 0, 1, 5, 1, 0, 0,14},
{14, 0, 0, 0, 0, 0, 0, 4, 0, 5, 1, 5, 0, 0,14},
{14, 0, 0, 0, 0, 0, 0, 4, 0, 1, 5, 1, 0, 0,14},
{14, 0, 0, 0, 0, 0, 0, 1, 0, 0, 0, 0, 0, 0,14},
{14, 2, 2, 2, 2, 2, 1, 1, 1, 1, 1, 1, 1, 1,14},
{14, 0, 0, 0, 0, 0, 0, 1, 0, 0, 0, 0, 0, 0,14},
{14, 0, 0, 0, 0, 0, 0, 3, 0, 0, 0, 0, 0, 0,14},
{14, 0, 0, 0, 0, 0, 0, 3, 0, 0, 0, 0, 0, 0,14},
{14, 0, 0, 0, 0, 0, 0, 3, 0, 0, 0, 0, 0, 0,14},
{14, 0, 0, 0, 0, 0, 0, 3, 0, 0, 0, 0, 0, 0,14},
{14, 0, 0, 0, 0, 0, 0, 3, 0, 0, 0, 0, 0, 0,14},
{14,14,14,14,14,14,14,14,14,14,14,14,14,14,14}
},

{
{14,14,14,14,14,14,14,14,14,14,14,14,14,14,14},
{14, 0, 0, 0, 0, 0, 0, 4, 0, 0, 0, 0, 0, 0,14},
{14, 0, 0, 0, 0, 0, 0, 4, 0, 0, 0, 0, 0, 0,14}, 
{14, 0, 0, 0, 0, 0, 0, 4, 0, 1, 1, 1, 0, 0,14},
{14, 0, 0, 0, 0, 0, 0, 4, 0, 1, 1, 1, 0, 0,14},
{14, 0, 0, 0, 0, 0, 0, 4, 0, 1, 1, 1, 0, 0,14},
{14, 0, 0, 0, 0, 0, 0, 1, 0, 0, 0, 0, 0, 0,14},
{14, 2, 2, 2, 2, 2, 1, 1, 1, 1, 1, 1, 1, 1,14},
{14, 0, 0, 0, 0, 0, 0, 1, 0, 0, 0, 0, 0, 0,14},
{14, 0, 0, 0, 0, 0, 0, 3, 0, 0, 0, 0, 0, 0,14},
{14, 0, 0, 0, 0, 0, 0, 3, 0, 0, 0, 0, 0, 0,14},
{14, 0, 0, 0, 0, 0, 0, 3, 0, 0, 0, 0, 0, 0,14},
{14, 0, 0, 0, 0, 0, 0, 3, 0, 0, 0, 0, 0, 0,14},
{14, 0, 0, 0, 0, 0, 0, 3, 0, 0, 0, 0, 0, 0,14},
{14,14,14,14,14,14,14,14,14,14,14,14,14,14,14}
},
{
{14,14,14,14,14,14,14,14,14,14,14,14,14,14,14},
{14, 0, 0, 0, 0, 0, 0, 4, 0, 0, 0, 0, 0, 0,14},
{14, 0, 0, 0, 0, 0, 0, 4, 0, 0, 0, 0, 0, 0,14}, 
{14, 0, 0, 0, 0, 0, 0, 4, 0, 1, 6, 1, 0, 0,14},
{14, 0, 0, 0, 0, 0, 0, 4, 0, 6, 1, 6, 0, 0,14},
{14, 0, 0, 0, 0, 0, 0, 4, 0, 1, 6, 1, 0, 0,14},
{14, 0, 0, 0, 0, 0, 0, 1, 0, 0, 0, 0, 0, 0,14},
{14, 2, 2, 2, 2, 2, 1, 1, 1, 1, 1, 1, 1, 1,14},
{14, 0, 0, 0, 0, 0, 0, 1, 0, 0, 0, 0, 0, 0,14},
{14, 0, 0, 0, 0, 0, 0, 3, 0, 0, 0, 0, 0, 0,14},
{14, 0, 0, 0, 0, 0, 0, 3, 0, 0, 0, 0, 0, 0,14},
{14, 0, 0, 0, 0, 0, 0, 3, 0, 0, 0, 0, 0, 0,14},
{14, 0, 0, 0, 0, 0, 0, 3, 0, 0, 0, 0, 0, 0,14},
{14, 0, 0, 0, 0, 0, 0, 3, 0, 0, 0, 0, 0, 0,14},
{14,14,14,14,14,14,14,14,14,14,14,14,14,14,14}
},
{
{14,14,14,14,14,14,14,14,14,14,14,14,14,14,14},
{14, 0, 0, 0, 0, 0, 0, 4, 0, 0, 0, 0, 0, 0,14},
{14, 0, 0, 0, 0, 0, 0, 4, 0, 0, 0, 0, 0, 0,14}, 
{14, 0, 0, 0, 0, 0, 0, 4, 0, 1, 1, 1, 0, 0,14},
{14, 0, 0, 0, 0, 0, 0, 4, 0, 1, 1, 1, 0, 0,14},
{14, 0, 0, 0, 0, 0, 0, 4, 0, 1, 1, 1, 0, 0,14},
{14, 0, 0, 0, 0, 0, 0, 1, 0, 0, 0, 0, 0, 0,14},
{14, 2, 2, 2, 2, 2, 1, 1, 1, 1, 1, 1, 1, 1,14},
{14, 0, 0, 0, 0, 0, 0, 1, 0, 0, 0, 0, 0, 0,14},
{14, 0, 0, 0, 0, 0, 0, 3, 0, 0, 0, 0, 0, 0,14},
{14, 0, 0, 0, 0, 0, 0, 3, 0, 0, 0, 0, 0, 0,14},
{14, 0, 0, 0, 0, 0, 0, 3, 0, 0, 0, 0, 0, 0,14},
{14, 0, 0, 0, 0, 0, 0, 3, 0, 0, 0, 0, 0, 0,14},
{14, 0, 0, 0, 0, 0, 0, 3, 0, 0, 0, 0, 0, 0,14},
{14,14,14,14,14,14,14,14,14,14,14,14,14,14,14}
},
{
{14,14,14,14,14,14,14,14,14,14,14,14,14,14,14},
{14, 0, 0, 0, 0, 0, 0, 4, 0, 0, 0, 0, 0, 0,14},
{14, 0, 0, 0, 0, 0, 0, 4, 0, 0, 0, 0, 0, 0,14}, 
{14, 0, 0, 0, 0, 0, 0, 4, 0, 0, 1, 0, 0, 0,14},
{14, 0, 0, 0, 0, 0, 0, 4, 0, 1, 1, 1, 0, 0,14},
{14, 0, 0, 0, 0, 0, 0, 4, 0, 0, 1, 0, 0, 0,14},
{14, 0, 0, 0, 0, 0, 0, 1, 0, 0, 0, 0, 0, 0,14},
{14, 2, 2, 2, 2, 2, 1, 1, 1, 1, 1, 1, 1, 1,14},
{14, 0, 0, 0, 0, 0, 0, 1, 0, 0, 0, 0, 0, 0,14},
{14, 0, 0, 0, 0, 0, 0, 3, 0, 0, 0, 0, 0, 0,14},
{14, 0, 0, 0, 0, 0, 0, 3, 0, 0, 0, 0, 0, 0,14},
{14, 0, 0, 0, 0, 0, 0, 3, 0, 0, 0, 0, 0, 0,14},
{14, 0, 0, 0, 0, 0, 0, 3, 0, 0, 0, 0, 0, 0,14},
{14, 0, 0, 0, 0, 0, 0, 3, 0, 0, 0, 0, 0, 0,14},
{14,14,14,14,14,14,14,14,14,14,14,14,14,14,14}
},

{
{14,14,14,14,14,14,14,14,14,14,14,14,14,14,14},
{14, 0, 0, 0, 0, 0, 0, 4, 0, 0, 0, 0, 0, 0,14},
{14, 0, 0, 0, 0, 0, 0, 4, 0, 0, 0, 0, 0, 0,14}, 
{14, 0, 0, 0, 0, 0, 0, 4, 0, 0, 0, 0, 0, 0,14},
{14, 0, 0, 0, 0, 0, 0, 4, 0, 0, 1, 0, 0, 0,14},
{14, 0, 0, 0, 0, 0, 0, 4, 0, 0, 0, 0, 0, 0,14},
{14, 0, 0, 0, 0, 0, 0, 1, 0, 0, 0, 0, 0, 0,14},
{14, 2, 2, 2, 2, 2, 1, 1, 1, 1, 1, 1, 1, 1,14},
{14, 0, 0, 0, 0, 0, 0, 1, 0, 0, 0, 0, 0, 0,14},
{14, 0, 0, 0, 0, 0, 0, 3, 0, 0, 0, 0, 0, 0,14},
{14, 0, 0, 0, 0, 0, 0, 3, 0, 0, 0, 0, 0, 0,14},
{14, 0, 0, 0, 0, 0, 0, 3, 0, 0, 0, 0, 0, 0,14},
{14, 0, 0, 0, 0, 0, 0, 3, 0, 0, 0, 0, 0, 0,14},
{14, 0, 0, 0, 0, 0, 0, 3, 0, 0, 0, 0, 0, 0,14},
{14,14,14,14,14,14,14,14,14,14,14,14,14,14,14}
},



//
};

